9 8

WWWWWWWWW
WFFFFFFFW
WFFFFFFFW
WFFFFFFFW
WFFFFFFFW
WFFFFFFFW
WFFFFFFFW
WWWWgWWWW

4|3|Bobby|npc.png



4|7|theHub|33|26