24 24



WWWWW..WWWWW            
WFFFFFFFFFFW            
WFFFFFFFFFFW            
WFFFFFFFFFFW            
WFFFFFFFFFFW            
WFFFFFFFFFFW            
WFFFFFFFFFFW            
WFFFFFFFFFFW            
WFFFFFFFFFFW            
WFFFFFFFFFFW            
WFFFFFFFFFFW            
WFFFFFFFFFFW            
WFFFFFFFFFFWWWWWWWWWWWWW
WFFFFFFFFFFFFFFFFFFFFFFW
WFFFFFFFFFFFFFFFFFFFFFFW
WFFFFFFFFFFFFFFFFFFFFFFW
WFFFFFFFFFFFFFFFFFFFFFFW
WFFFFFFFFFFFFFFFFFFFFFF.
WFFFFFFFFFFFFFFFFFFFFFF.
WFFFFFFFFFFFFFFFFFFFFFFW
WFFFFFFFFFFFFFFFFFFFFFFW
WFFFFFFFFFFFFFFFFFFFFFFW
WFFFFFFFFFFFFFFFFFFFFFFW
WWWWWWWWWWWWWWWWWWWWWWWW

20|15|English|npc.png
10|13|Math|npc.png
3|21|Science|npc.png
18|14|History|npc.png
5|8|Languages|npc.png
17|14|Psychology|npc.png
4|6|Art|npc.png



23|17|theHub|1|11
23|18|theHub|1|12