9 8



WWWWWWWWW
WFFFFFFFW
WFFFFFFFW
WFFFFFFFW
WFFFFFFFW
WFFFFFFFW
WFFFFFFFW
WWWWFWWWW



4|6|Can't go in small room

4|7|testMap|2|1